###########
#    S    #
# ####### #
#  #####  #
###  #  ###
#### # ####
#### # ####
####   ####
#####    F#
###########