###################################
####S ######         F#############
#####  #####   ####################
######   ###                    ###
########   #  #####################
##########   ######################
##########   ######################
###################################