####################################
#############################      #
#############################      #
############################# ######
############################# ######
############################# ######
                S############ ######
##### ########## ############ ######
##### ########## ############ ######
##### ###### ### ############ ######
##### ###### ### ############ ######
##### ###### ###              ######
############ ###  ##################
############      ##################
################ ########### F######
################   ######### #######
#################            #######
####################################