############
#         S#
# ##########
# ##########
# ##########
# ##########
# ##########
# ##########
# ##########
# ##########
#     F#####
############

