########
###S ###
###  ###
###  ###
#     ##
### ####
### ####
###  F##
########