####################
#########S##########
######    ##########
######### ##########
###             F###
####################