########
       #
# ### ##
# ### ##
#S####F#
# ######