##############
###S         #
###  ####### #
###  ####### #
###  ####### #
###  ####### #
############ #
#####F       #
##############