##### ####################
##### ####################
##### ####################
##### ######           ###
##### ###### ######### ###
##### ###### ######### ###
#####       S######### ###
######################    
###################### ###
###################    ###
##################  ######
############F      #######
##########################
##########################