#################
#S             ##
# ###### ##### ##
# ###### ##### ##
# ###### ##### ##
# ###### ##### ##
# ###### ##### ##
  ###### ###### #
 ####### ########
   #####         
## ############ #
## ###########  #
##  ########### #
###   ######### #
############### #
###############F#
#################