#########
###S#####
###     #
###  ####
##F  ####
#########
#########