####################
##S             ####
############### ####
############### ####
####F########## ####
####  ######### ####
      ######### ####
#### ########## ####
#### ########## ####
                ####
####################
####################
